WWPWWWVWWW
W........W
W.W......W
W........W
W........W
W....@...W
W........W
W........W
W........W
WWWWWWWWWW

