WWWWWWWWWW
W........W
W........V
W........W
W........W
W........W
W........W
W.@...L..W
W........W
WWWWWWWWWW

