WWWWPWWWWW
W........W
W........W
W........W
W........P
W....@...W
P........W
W........W
W........W
WWWWWVWWWW

